			 Level 3 Puzzle

=========================================
|| 3 | 6 | 4 || 5 | 1 | 9 || 2 | 7 | 8 ||
-----------------------------------------
|| 7 | 9 |   || 6 | 4 | 8 || 5 |   | 1 ||
-----------------------------------------
|| 5 | 1 |   || 3 |   | 7 || 4 | 9 |   ||
=========================================
|| 1 | 2 | 7 || 9 | 8 | 4 || 6 | 5 |   ||
-----------------------------------------
||   | 4 | 5 || 2 | 3 | 6 ||   |   | 7 ||
-----------------------------------------
|| 8 | 3 | 6 || 7 | 5 |   || 9 | 4 | 2 ||
=========================================
|| 4 | 8 | 9 ||   |   | 3 || 7 | 2 | 5 ||
-----------------------------------------
|| 2 |   | 1 || 8 |   | 5 || 3 | 6 | 4 ||
-----------------------------------------
|| 6 |   |   || 4 |   | 2 || 1 |   | 9 ||
=========================================


