Level 6

=========================================
||   |   |   || 2 |   | 9 ||   | 4 |   ||
-----------------------------------------
||   | 2 | 1 || 3 |   |   || 6 | 9 | 8 ||
-----------------------------------------
||   |   | 8 || 1 |   | 6 || 3 |   | 7 ||
=========================================
||   |   | 9 ||   |   |   ||   |   | 3 ||
-----------------------------------------
|| 2 |   |   || 7 |   | 1 || 8 | 5 | 6 ||
-----------------------------------------
|| 7 |   | 5 || 6 | 3 | 2 || 9 | 1 | 4 ||
=========================================
|| 8 |   |   || 9 | 2 |   ||   | 3 | 1 ||
-----------------------------------------
|| 9 |   | 3 || 8 | 1 |   ||   |   |   ||
-----------------------------------------
|| 1 | 7 |   || 4 |   | 3 || 5 | 8 |   ||
=========================================


