			Level 9 Puzzle

=========================================
||   | 4 |   ||   | 8 |   ||   | 2 |   ||
-----------------------------------------
||   | 6 | 3 ||   |   | 5 ||   |   |   ||
-----------------------------------------
||   | 5 |   ||   |   | 2 || 1 |   | 6 ||
=========================================
||   |   | 1 ||   |   | 4 ||   |   | 3 ||
-----------------------------------------
|| 4 |   |   || 7 |   | 1 ||   |   |   ||
-----------------------------------------
||   |   |   || 2 |   | 8 || 4 |   |   ||
=========================================
|| 7 |   |   || 6 |   | 3 ||   |   |   ||
-----------------------------------------
||   |   | 5 || 8 |   |   ||   |   | 7 ||
-----------------------------------------
||   | 9 | 2 ||   |   |   ||   |   |   ||
=========================================


