		Level 5Puzzle

=========================================
|| 4 | 6 | 5 || 1 | 8 | 2 ||   | 7 | 9 ||
-----------------------------------------
|| 7 | 8 | 2 ||   |   |   || 6 | 4 |   ||
-----------------------------------------
|| 9 | 1 |   || 7 |   | 4 ||   |   | 2 ||
=========================================
|| 6 | 2 | 4 || 9 | 7 |   || 1 | 8 |   ||
-----------------------------------------
||   | 5 | 9 ||   | 4 | 8 || 7 | 3 |   ||
-----------------------------------------
||   |   |   || 6 |   |   || 9 | 2 |   ||
=========================================
|| 3 | 9 |   || 4 | 2 |   ||   | 1 | 7 ||
-----------------------------------------
|| 2 | 7 | 1 ||   | 9 |   || 4 | 6 | 8 ||
-----------------------------------------
|| 5 | 4 |   || 8 |   |   || 2 |   |   ||
=========================================


