
=========================================
||   | 9 | 6 ||   | 8 |   ||   |   |   ||
-----------------------------------------
||   | 7 | 2 ||   |   |   ||   | 4 |   ||
-----------------------------------------
||   | 4 | 3 || 6 |   | 7 ||   | 1 | 9 ||
=========================================
|| 2 |   | 5 || 4 | 7 | 1 ||   |   |   ||
-----------------------------------------
||   | 1 |   ||   |   | 5 ||   | 6 |   ||
-----------------------------------------
|| 3 |   | 7 ||   |   |   || 4 | 5 |   ||
=========================================
|| 6 |   |   || 7 | 4 |   ||   |   | 5 ||
-----------------------------------------
||   |   |   || 3 |   |   ||   |   | 4 ||
-----------------------------------------
||   |   |   || 1 |   | 8 ||   | 2 |   ||
=========================================


